11111111
100000C1
1P000111
10CCC001
11000001
11000001
10I00E01
11111111