111111111111111
100I00C00000C01
1P0001111100111
10C0C0000001111
110000011110001
11P000E00000011
10100C011110001
111111111111111