1111111111111111111111111
1000000000000000000000001
100000CCCCCCC111000011101
100000P000000000000000001
1111110000101001110011111
11E11100000I1110000000001
1000000000000000000000001
1111111111111111111111111
