1111111111111111111111111111
10000C00000000000000C0000001
1000000000000000000000000001
1011111000100001000111110001
1010000000100001000100000001
1011111000100001000111110001
1000001000100001000000010001
1011111000111111000111110001
1000000000000000000000000001
10P0000000C00000000000000001
1000000000000000CCCCCCC00001
1111111111111111111111111111