1111111111111111111111111111
1000000000000000000000000001
1000000000000000000000000001
1011111000100001000111110001
1010000000100001000100000001
1011111000100001000111110001
1000001000100001000000010001
1011111000111111000111110001
1000000000000000000000000001
10P00E0000C00000000000000001
100000000000000CCCCCCC000001
1111111111111111111111111111