1111111111111111111111111
1000000000000000000000001
1000CCCCC0000011111100001
1000000000000000111000001
111111000000P111111111001
1000000000001000000000001
1E1111111100I011000000001
1000000000000000000011011
1000000000000000000011011
1000000000001000000011011
1000000000000000000011011
1000000000000000000011011
1111111111111111111111111
