1111111111111111111111111
1000000000000000000000E01
1000CCCCC0000011111100001
1000000000000000111000001
11111100P0000111111111001
1000000000000000000000001
1011111111111111000000001
1000000000000000000011011
1111111111111111111111111